10 x 10
0 0 0 0 0 0 0 0 0 0
0 1 - - 2 0 0 0 0 0
0 | 0 0 | 0 0 0 0 0
0 | 0 0 | 0 0 0 0 0
0 | 0 0 4 - - - 2 0
0 | 0 0 0 0 0 0 | 0
0 | 0 0 0 1 - - 3 0
0 | 0 0 0 | 0 0 0 0
0 4 - - - 3 0 0 0 0
0 0 0 0 0 0 0 0 0 0
